W	W	W	W	W	W	W	W	W	W	W	W
W	W	W	W	W	W	F	F	F	F	F	W
W	W	W	W	W	W	F	W	W	W	F	W
W	W	W	W	W	W	F	W	W	W	F	W
W	W	W	W	W	W	F	W	W	W	F	W
W	W	W	W	W	W	F	S	S	S	F	W
W	F	T	F	F	B	F	W	W	W	T	W
W	W	W	W	W	W	F	D	D	F	F	W
W	W	W	W	W	W	W	W	W	W	W	W