W	W	W	W	W	W	W	W	W	W	W	W	W
W	F	F	T	F	F	F	W	W	W	W	W	W
W	F	W	W	W	W	F	W	W	W	W	W	W
W	T	F	F	F	B	F	T	F	F	F	T	W
W	W	W	W	F	W	F	W	W	W	W	W	W
W	W	W	W	F	F	F	W	W	W	W	W	W
W	W	W	W	W	W	W	W	W	W	W	W	W